0,1,1,31,31,30,30,60,60,61,61,62,62,63,63,64,64,65,65,95,95,96,96,97,97,127,127,128,128,158,158,159,159,129,129,130,130,131,131,161,161,191,191,221,221,220,220,190,190,160,190,189,189,188,188,218,218,219,219,249,249,279,279,309,309,339,339,338,338,337,337,367,367,368,368,369,369,370,370,400,400,401,401,402,402,403,403,373,373,374,374,344,344,343,343,313,313,314,314,315,315,285,285,286,286,287,287,257,257,258,258,259,259,289,289,319,319,320,320,290,290,291,291,292,292,262,262,232,232,202,202,201,201,171,171,172,172,173,173,143,143,144,144,145,145,175,175,205,205,206,206,236,236,266,266,265,265,295,295,325,325,326,326,356,356,386,386,385,385,415,415,416,416,417,417,418,418,448,448,449,449,479,479,478,478,508,508,538,538,539,539,569,569,599,599,598,598,597,597,596,596,595,595,594,594,564,564,563,563,533,533,503,503,504,504,474,474,444,444,445,445,475,475,505,505,506,506,536,536,566,566,565,565,535,535,534,566,567,567,568,567,537,537,507,507,477,477,447,447,446,446,476,444,414,414,384,384,383,383,382,382,352,352,351,351,381,381,380,380,379,379,409,409,439,439,440,440,470,470,500,500,501,501,531,531,532,532,502,502,472,472,471,471,441,441,442,442,412,412,411,411,410,412,413,413,443,443,473,532,562,562,561,561,591,591,592,592,593,591,590,590,589,589,588,588,558,558,557,557,556,556,526,526,527,527,528,528,529,529,559,559,560,560,530,529,499,499,498,498,497,497,467,467,466,466,465,465,464,464,463,463,493,493,494,494,524,524,525,525,555,555,554,554,584,584,585,585,586,586,587,584,583,583,582,582,552,552,553,553,523,523,522,522,492,492,491,491,490,490,520,520,519,519,549,549,579,579,578,578,548,548,547,547,517,517,487,487,457,457,456,456,426,426,425,425,395,395,396,396,366,366,365,365,364,364,394,394,424,424,454,454,455,455,485,485,484,484,514,514,513,513,512,512,511,511,481,481,451,451,452,452,482,482,483,483,453,453,423,423,422,422,421,421,391,391,392,392,393,393,363,363,333,333,334,334,304,304,305,305,306,306,336,336,335,306,307,307,277,277,247,247,217,217,216,216,215,215,185,185,155,155,156,156,157,157,187,187,186,156,126,126,125,125,124,124,154,154,153,153,152,152,122,122,121,121,151,151,181,181,182,182,212,212,213,213,214,214,184,184,183,214,244,244,274,274,273,273,272,272,271,271,270,270,300,300,301,301,331,331,332,332,362,362,361,361,360,360,390,390,420,420,450,450,480,480,510,510,540,540,541,541,571,571,572,572,542,542,543,543,544,544,574,574,575,575,545,545,515,515,516,516,546,546,576,576,577,516,486,574,573,571,570,360,330,332,302,302,303,270,240,240,241,241,211,211,210,210,180,180,150,150,120,120,90,90,91,91,92,92,93,93,123,93,94,241,242,242,243,274,275,275,276,276,246,246,245,247,248,248,278,278,308,396,397,397,427,427,428,428,398,398,399,399,429,429,430,430,431,431,461,461,460,460,459,459,489,489,488,488,518,488,458,461,462,462,432,432,433,433,434,434,435,435,436,436,437,437,407,407,408,408,438,438,468,468,469,408,378,378,377,377,347,347,346,346,316,316,317,317,318,318,288,318,348,348,349,349,350,346,345,345,375,375,376,376,406,406,405,405,404,579,580,580,581,581,551,551,550,551,521,525,495,495,496,351,321,321,322,322,323,323,324,324,294,294,264,264,234,234,235,234,233,233,203,203,204,204,174,233,263,263,293,324,354,354,355,354,353,539,509,449,419,419,389,389,388,388,358,358,359,359,329,329,299,299,298,298,297,297,267,267,268,268,269,269,239,239,209,209,179,179,178,178,208,208,207,207,177,177,147,147,148,148,118,118,117,117,87,87,88,88,58,58,59,59,89,89,119,119,149,59,29,29,28,28,27,27,57,57,56,56,55,55,25,25,26,25,24,24,54,54,53,53,83,83,84,84,85,85,115,115,116,116,86,116,146,146,176,115,114,114,113,113,112,112,82,82,81,81,51,51,50,50,80,80,110,110,111,111,141,141,142,141,140,140,139,139,169,169,168,168,138,138,137,137,107,107,77,77,47,47,46,46,16,16,15,15,45,45,44,44,14,14,13,13,43,43,42,42,72,72,71,71,101,101,100,100,99,99,98,98,68,68,69,69,39,39,38,38,37,37,67,67,66,66,36,36,6,6,5,5,35,35,34,34,4,4,3,3,2,2,32,32,33,6,7,7,8,8,9,9,10,10,40,40,70,40,41,41,11,11,12,101,102,102,103,103,133,133,132,132,162,162,163,163,193,193,194,194,224,224,225,225,195,195,165,165,166,166,167,167,197,197,227,227,228,228,229,229,230,230,231,231,261,261,260,230,200,200,170,200,199,199,198,227,226,226,196,226,256,256,255,255,254,254,253,253,223,223,222,222,192,222,252,252,282,282,283,283,284,282,281,281,280,280,310,310,340,340,341,341,371,371,372,372,342,342,312,312,311,280,250,250,251,166,136,136,106,106,76,76,75,75,105,105,135,135,134,134,104,104,74,74,73,134,164,16,17,17,18,18,19,19,49,49,79,79,78,78,108,108,109,78,48,19,20,20,21,21,22,22,23,22,52,207,237,237,238,297,296,297,327,327,357,357,387,327,328
0,30,30,60,60,61,61,91,91,90,90,120,120,121,121,151,151,150,150,180,180,181,181,211,211,212,212,213,213,243,243,244,244,274,274,273,273,303,303,302,302,301,301,331,331,361,361,360,360,390,390,420,420,421,421,451,451,450,450,480,480,510,510,511,511,512,512,482,482,481,482,483,483,513,513,543,543,544,544,574,574,575,575,576,576,546,546,545,545,515,515,514,514,484,484,454,454,455,455,456,456,426,426,396,396,366,366,336,336,306,306,305,305,335,335,365,365,364,364,394,394,393,393,392,392,422,422,452,452,453,453,423,423,424,424,425,425,395,392,362,362,332,332,333,333,334,334,304,333,363,392,391,305,275,275,276,276,277,277,278,278,279,279,249,249,250,250,251,251,221,221,222,222,252,252,253,253,223,223,224,224,254,254,284,284,314,314,315,315,285,285,255,255,225,225,195,195,194,194,193,193,192,192,191,191,190,190,220,220,219,219,189,189,188,188,158,158,157,157,187,187,186,186,216,216,246,246,247,247,248,248,218,218,217,246,245,245,215,215,214,214,184,184,183,183,182,182,152,152,122,122,92,92,62,62,63,63,93,93,123,123,153,153,154,154,155,155,156,156,126,126,96,96,97,97,127,127,128,128,98,98,68,68,38,38,8,8,9,9,10,10,11,11,12,12,42,42,72,72,71,71,41,41,40,40,39,39,69,69,70,70,100,100,101,101,131,131,130,130,160,160,161,161,162,162,163,163,164,164,165,165,135,135,105,105,104,104,134,134,133,133,132,132,102,102,103,103,73,73,43,43,13,13,14,14,44,44,45,45,15,15,16,16,17,17,18,18,19,19,49,49,50,50,20,20,21,21,51,51,52,52,53,53,23,23,24,24,54,54,84,84,85,85,55,55,25,25,26,26,27,27,28,28,29,29,59,59,58,58,57,57,87,87,86,86,116,116,115,115,114,114,144,144,145,145,175,175,176,176,177,177,147,147,148,148,178,178,179,179,149,149,119,119,118,118,88,88,89,118,117,179,209,209,208,208,238,238,239,239,269,269,268,268,298,298,328,328,327,327,297,297,267,267,237,237,207,207,206,206,236,236,266,266,265,265,235,235,234,234,233,233,263,263,264,264,294,294,295,295,296,296,326,326,325,325,324,324,323,323,322,322,352,352,353,353,383,383,413,413,414,414,444,444,443,443,442,442,441,441,411,411,410,410,440,440,470,470,500,500,499,499,469,469,439,439,438,438,437,437,436,436,466,466,496,496,497,497,527,527,526,526,556,556,586,586,587,587,557,557,558,558,528,528,529,529,559,559,589,589,590,590,560,560,530,530,531,531,532,532,502,502,501,501,471,471,472,472,473,473,474,474,475,475,445,445,446,446,447,447,417,417,387,387,386,386,416,416,415,415,385,385,355,355,354,354,384,355,356,356,357,357,358,358,359,359,389,389,419,419,449,449,479,479,478,478,477,477,476,476,506,506,505,505,535,535,536,536,566,566,567,567,597,597,598,598,599,599,569,569,539,539,509,509,508,508,507,507,537,537,538,538,568,597,596,596,595,595,565,565,564,564,534,534,533,533,503,503,504,533,563,563,562,562,561,561,591,591,592,592,593,593,594,478,448,448,418,418,388,359,329,329,299,589,588,528,498,498,468,468,467,586,585,585,584,584,554,554,524,524,494,494,493,493,523,523,553,553,552,552,551,551,550,550,580,580,579,579,549,549,519,519,518,518,548,548,578,578,577,577,547,547,517,517,487,487,486,486,516,486,485,487,488,488,489,489,490,490,491,491,521,521,520,521,522,522,492,492,462,462,463,463,464,464,465,465,495,495,525,525,555,465,435,435,434,434,404,404,405,405,406,406,407,407,377,377,347,347,317,317,287,287,286,286,316,316,346,346,376,376,375,375,374,374,373,373,372,372,402,402,403,403,433,433,432,432,431,431,430,430,460,460,461,460,459,459,429,429,399,399,398,398,397,397,427,427,428,428,458,458,457,397,367,367,337,337,307,307,308,308,338,338,368,368,369,369,370,370,371,371,341,341,342,342,312,312,311,311,281,281,282,282,283,283,313,313,343,343,344,344,345,281,280,280,310,310,309,309,339,339,340,371,401,401,400,286,256,256,257,257,227,227,197,197,198,198,168,168,169,169,199,199,229,229,259,259,258,258,228,258,288,288,289,289,319,319,349,349,348,348,318,348,378,378,379,379,380,380,350,350,351,351,381,381,382,382,412,351,321,321,291,291,292,292,293,292,262,262,261,261,231,231,232,232,202,202,201,201,200,200,230,230,260,260,290,290,320,200,170,170,171,171,141,141,142,142,172,172,173,173,143,143,113,113,112,112,111,111,81,81,80,80,110,110,109,109,108,108,107,107,106,106,136,136,166,166,196,196,226,166,167,167,137,137,138,138,139,139,140,106,76,76,77,77,78,78,79,78,48,48,47,47,46,76,75,75,74,81,82,82,83,173,174,174,204,204,203,204,205,379,409,409,408,580,581,581,582,582,583,147,146,86,56,23,22,160,159,159,129,129,99,8,7,7,6,6,36,36,66,66,65,65,35,35,5,5,4,4,34,34,33,33,3,3,2,2,1,1,31,31,32,34,64,64,94,94,95,95,125,125,124,66,67,67,37,155,185,574,573,573,572,572,571,571,541,541,540,540,570,541,542,360,330,330,300,300,270,270,240,240,210,240,241,241,242,242,272,272,271
0,30,30,60,60,61,61,91,91,90,90,120,120,150,150,180,180,181,181,151,151,152,152,153,153,154,154,124,124,123,123,93,93,94,94,95,95,65,65,66,66,96,96,126,126,156,156,186,186,216,216,217,217,247,247,246,246,276,276,275,275,274,274,244,244,214,214,215,215,245,215,185,185,184,184,183,183,182,182,212,212,242,242,272,272,271,271,241,241,211,211,210,210,240,240,270,270,300,300,301,301,331,331,361,361,362,362,332,332,333,333,334,334,335,335,336,336,337,337,307,307,306,306,305,305,304,304,303,303,273,273,243,243,213,303,302,307,308,308,278,278,279,279,249,249,250,250,220,220,190,190,189,189,219,219,218,218,248,218,188,188,187,187,157,157,127,127,128,128,98,98,68,68,38,38,39,39,40,40,41,41,11,11,10,10,9,9,8,8,7,7,37,37,36,36,35,35,34,34,33,33,63,63,64,63,62,62,92,92,122,122,121,62,32,32,2,2,3,3,4,4,5,5,6,2,1,1,31,37,67,67,97,11,12,12,13,13,43,43,42,42,72,72,71,71,70,70,100,100,99,99,69,99,129,129,159,159,158,159,160,160,161,161,131,131,132,132,102,102,101,102,103,103,133,133,134,134,164,164,165,165,195,195,225,225,224,224,254,254,253,253,223,223,193,193,194,193,163,163,162,162,192,192,222,222,252,252,251,251,221,221,191,251,281,281,282,282,312,312,342,342,343,343,373,373,403,403,402,402,372,372,371,371,401,401,400,400,430,430,431,431,461,461,491,491,492,492,522,522,552,552,553,553,583,583,584,584,585,585,555,555,554,554,524,524,523,523,493,493,463,463,464,464,465,465,435,435,434,434,404,404,405,405,406,406,407,407,408,408,438,438,468,468,498,498,499,499,529,529,559,559,558,558,528,528,527,527,497,497,496,496,466,466,467,467,437,437,436,496,495,495,494,495,525,525,526,526,556,556,586,586,587,587,557,587,588,588,589,589,590,590,591,591,561,561,562,562,592,592,593,593,563,563,533,533,503,503,504,504,505,505,506,506,476,476,477,477,447,447,446,446,416,416,386,386,387,387,357,357,356,356,355,355,325,325,295,295,296,296,297,297,267,267,268,268,298,298,299,299,269,269,239,239,209,209,208,208,178,178,179,179,149,149,119,119,89,89,88,88,87,87,117,117,116,116,115,115,85,85,86,86,56,56,57,57,27,27,26,26,25,25,55,55,54,54,24,24,23,23,53,53,52,52,82,82,83,83,84,84,114,114,144,144,143,143,142,142,172,172,171,171,141,141,111,111,110,110,109,109,79,79,49,49,19,19,20,20,21,21,22,21,51,51,50,50,80,80,81,19,18,18,48,48,78,78,77,77,107,107,108,108,138,138,139,139,140,140,170,170,200,200,201,201,202,202,203,203,233,233,234,234,235,235,265,265,266,266,236,236,206,206,176,176,146,146,147,147,148,148,118,147,177,177,207,207,237,237,238,146,145,145,175,175,205,205,204,204,174,174,173,265,264,264,263,263,262,262,232,232,231,231,261,261,291,291,321,321,322,322,292,292,293,293,323,323,353,353,352,352,382,382,383,383,384,384,354,354,324,324,294,384,385,385,415,415,414,414,444,444,443,443,442,442,441,441,440,440,470,470,500,500,501,501,531,531,532,532,502,502,472,472,473,473,474,474,475,475,445,472,471,531,530,530,560,470,469,469,439,439,409,409,379,379,380,380,410,410,411,411,412,412,413,411,381,381,351,351,350,350,320,320,290,290,260,260,230,230,229,229,259,259,289,289,288,288,287,287,257,257,258,258,228,228,227,227,226,226,256,256,255,255,285,285,286,286,316,316,346,346,376,376,375,375,374,374,344,344,345,345,315,315,314,314,284,284,283,283,313,376,377,377,378,378,348,348,347,347,317,317,318,318,319,319,349,226,196,196,197,197,167,167,168,168,198,198,199,199,169,167,166,166,136,136,106,106,105,105,104,104,74,74,73,74,44,44,45,45,46,46,47,47,17,17,16,16,15,15,14,46,76,76,75,105,135,136,137,111,112,112,113,27,28,28,58,58,59,59,29,299,329,329,328,328,358,358,388,388,418,418,419,419,389,389,359,419,449,449,448,448,478,478,479,479,509,509,539,539,538,538,537,537,536,536,535,535,565,565,564,564,594,594,595,595,596,596,566,566,567,567,568,568,569,569,599,599,598,598,597,564,534,537,507,507,508,418,417,328,327,327,326,434,433,433,432,432,462,583,582,582,581,581,551,551,521,521,520,520,490,490,489,489,519,519,549,549,579,579,580,580,550,579,578,578,548,548,547,547,546,546,545,545,575,575,576,576,577,575,574,574,544,544,514,514,513,513,512,512,482,482,452,452,422,422,421,421,420,420,390,390,360,360,330,390,391,391,392,392,393,393,423,423,424,424,454,454,455,455,456,456,426,426,427,427,428,428,429,429,399,399,369,369,370,370,340,340,310,310,280,310,311,311,341,310,309,309,339,339,338,338,368,368,367,367,397,397,396,396,366,366,365,365,395,395,425,395,394,394,364,364,363,397,398,429,459,459,460,459,458,458,488,488,487,487,457,487,517,517,516,516,486,486,485,485,515,485,484,484,483,483,453,517,518,420,450,450,451,451,481,481,480,480,510,510,540,540,570,570,571,571,541,541,542,542,572,572,573,573,543,541,511,131,130,278,277,185,155,155,125
0,30,30,31,31,61,61,62,62,63,63,93,93,92,92,91,91,121,121,120,120,90,90,60,120,150,150,180,180,210,210,240,240,241,241,211,211,181,181,151,151,152,152,153,153,183,183,213,213,212,212,242,242,243,243,273,273,303,303,333,333,332,332,302,302,272,272,271,271,270,270,300,300,301,301,331,331,361,361,362,362,392,392,422,422,423,423,453,453,454,454,484,484,514,514,513,513,543,543,544,544,574,574,573,573,572,572,542,542,512,512,511,511,510,510,540,540,541,541,571,571,570,510,480,480,450,450,451,451,481,481,482,482,452,482,483,451,421,421,391,391,390,390,360,360,330,390,420,574,575,575,576,576,577,577,547,547,548,548,578,578,579,579,580,580,581,581,582,582,552,552,522,522,492,492,462,462,461,461,431,431,430,430,429,429,428,428,427,427,457,457,487,487,488,488,518,518,517,517,516,516,486,486,485,485,515,515,545,545,546,485,455,455,425,425,426,426,396,396,395,395,365,365,366,366,367,367,368,368,398,398,399,399,400,400,370,370,371,371,341,341,340,340,310,310,280,280,281,281,311,311,312,312,342,342,372,372,373,373,343,343,313,313,314,314,315,315,316,316,346,346,347,347,348,348,349,349,350,350,380,380,410,410,440,440,439,439,469,469,468,468,438,438,437,437,467,467,497,497,496,496,526,526,527,527,557,557,587,587,586,586,585,585,584,584,583,583,553,553,523,523,524,524,554,554,555,555,556,555,525,525,495,495,494,494,464,464,465,465,466,466,436,436,406,406,376,376,375,375,374,374,344,344,345,374,404,404,403,403,433,433,463,463,493,433,432,432,402,402,401,433,434,434,435,435,405,376,377,377,378,378,408,408,407,408,409,409,379,587,588,588,558,558,559,559,560,560,561,561,531,531,501,501,502,502,503,503,504,504,505,505,535,535,536,536,566,566,567,567,568,568,598,598,599,599,569,569,539,539,509,509,479,479,449,449,419,419,389,389,388,388,418,418,417,417,416,416,446,446,447,447,477,477,476,476,475,475,445,445,444,444,414,414,413,413,412,412,411,411,381,381,382,382,352,352,322,322,321,321,320,320,319,319,318,318,317,317,287,287,288,288,258,258,228,228,229,229,199,199,169,169,139,139,138,138,168,168,198,198,197,197,196,196,166,166,167,167,137,137,136,136,135,135,165,165,195,195,225,225,226,226,227,227,257,257,256,256,286,286,285,285,255,255,254,254,253,253,223,223,224,224,194,194,193,193,163,163,164,164,134,134,104,104,105,105,75,75,74,74,44,44,14,14,15,15,16,16,17,17,47,47,46,46,45,46,76,76,106,106,107,107,108,108,78,78,77,78,48,48,18,18,19,19,49,49,79,79,80,80,81,81,51,51,50,50,20,20,21,21,22,22,52,52,82,82,83,83,113,113,143,143,144,144,174,174,204,204,205,205,235,235,265,265,264,264,294,294,293,293,292,292,291,291,290,290,289,289,259,259,260,260,261,261,262,262,263,263,233,233,203,203,202,202,232,232,231,231,201,201,200,200,230,200,170,170,171,171,141,141,142,142,172,172,173,142,112,112,111,111,110,110,140,110,109,233,234,293,323,323,353,353,354,354,384,384,383,384,385,385,355,355,325,325,326,326,327,327,357,357,387,387,386,386,356,357,358,358,328,328,298,298,299,299,269,269,268,268,267,267,297,297,296,296,295,296,266,266,236,236,206,206,176,176,175,175,145,145,115,115,114,114,84,84,85,85,55,55,25,25,26,26,56,56,86,86,87,87,88,88,118,118,117,117,147,147,177,177,207,207,208,208,178,178,148,148,149,149,179,179,209,209,239,239,238,238,237,149,119,119,89,89,59,59,58,58,28,28,27,27,57,28,29,147,146,146,116,25,24,24,54,54,53,53,23,299,329,329,359,325,324,385,415,14,13,13,43,43,73,73,103,103,102,102,72,72,71,71,101,101,100,100,99,99,129,129,128,128,127,127,126,126,156,156,186,186,216,216,246,246,247,247,248,248,249,249,250,250,251,251,221,221,191,191,190,190,220,220,219,219,218,218,217,217,187,187,188,188,189,189,159,159,158,158,157,159,160,160,130,130,131,131,161,161,162,162,192,192,222,222,252,252,282,282,283,283,284,162,132,132,133,249,279,279,278,278,308,308,307,307,306,306,336,336,335,335,334,334,304,304,305,305,275,275,276,276,277,275,274,274,244,244,214,214,184,184,154,154,124,124,94,94,64,64,34,34,35,35,65,65,66,66,96,96,95,95,125,125,155,155,185,185,215,215,245,96,97,97,67,67,37,37,36,36,6,6,7,7,8,8,9,9,39,39,69,69,68,68,98,68,38,69,70,70,40,40,41,41,11,11,10,11,12,12,42,6,5,5,4,4,3,3,2,2,32,32,33,2,1,124,123,123,122,334,364,364,363,363,393,393,394,394,424,336,337,337,338,338,339,339,309,339,369,321,351,411,441,441,442,442,443,443,473,473,472,472,471,471,470,470,500,500,530,530,529,529,499,499,498,498,528,473,474,476,506,506,507,507,537,537,538,538,508,508,478,478,448,598,597,597,596,596,595,595,594,594,564,564,565,564,534,534,533,533,532,532,562,562,563,563,593,593,592,592,591,591,590,590,589,398,397,426,456,518,519,519,520,520,490,490,491,491,521,521,551,551,550,550,549,490,489,489,459,459,460,459,458,212,182
0,30,30,60,60,61,61,91,91,92,92,62,62,32,32,33,33,3,3,2,2,1,1,31,3,4,4,34,34,64,64,65,65,35,35,5,5,6,6,7,7,37,37,36,36,66,66,67,67,68,68,69,69,70,70,100,100,99,99,98,98,128,128,129,129,130,130,160,160,161,161,131,131,132,132,133,133,163,163,164,164,165,165,135,135,136,136,166,166,167,167,137,137,107,107,108,108,109,109,79,79,80,80,81,81,82,82,112,112,113,113,114,114,84,84,54,54,53,53,52,52,22,22,21,21,20,20,50,50,49,49,19,19,18,18,17,17,16,16,15,15,45,45,44,44,74,74,73,73,103,103,102,102,101,101,71,71,72,72,42,42,12,12,11,11,10,10,40,40,41,40,39,39,9,9,8,8,38,12,13,13,14,13,43,103,104,104,134,104,105,105,75,75,76,76,77,77,78,78,48,48,47,47,46,76,106,50,51,22,23,23,24,24,25,25,55,55,85,85,115,115,145,145,144,144,174,174,175,175,205,205,235,235,234,234,204,204,203,203,202,202,172,172,173,173,143,143,142,142,141,141,111,111,110,110,140,140,170,170,169,169,199,199,198,198,197,197,196,196,226,226,225,225,195,195,194,194,224,224,254,254,284,284,285,285,315,315,345,345,344,344,314,314,313,313,283,283,282,282,312,312,311,311,341,341,342,342,372,372,371,371,370,370,400,400,401,401,402,402,403,403,404,404,434,434,433,433,463,463,462,462,461,461,491,491,490,490,489,489,519,519,518,518,488,488,487,487,517,517,516,516,515,515,545,545,546,546,547,547,548,548,549,549,579,579,578,578,577,577,576,576,575,575,574,574,573,573,543,543,513,513,512,512,511,511,481,481,480,480,450,450,420,420,421,421,451,451,452,452,422,422,392,392,362,362,332,332,302,302,272,272,273,273,243,243,244,244,214,214,213,213,183,183,182,182,181,181,151,151,152,152,122,122,121,121,120,120,90,120,150,150,180,180,210,210,211,211,212,212,242,242,241,241,240,240,270,270,300,300,330,330,360,360,390,390,391,391,361,361,331,331,301,301,271,122,123,123,93,93,63,93,94,94,95,95,125,125,126,126,96,96,97,97,127,127,157,157,158,158,188,188,189,189,190,190,191,191,192,192,162,192,222,222,221,221,251,251,250,250,249,249,248,248,218,218,219,219,220,218,217,217,187,187,186,186,216,216,246,246,245,245,275,275,305,305,306,306,276,276,277,277,307,307,308,308,338,338,339,339,369,369,399,399,429,429,428,428,458,458,457,457,427,427,426,426,396,396,397,397,398,398,368,368,367,367,366,366,365,365,395,395,425,425,455,455,454,454,484,484,483,483,453,453,423,423,393,393,363,363,364,364,334,334,304,304,274,304,303,303,333,334,335,335,336,336,337,364,394,394,424,483,482,484,514,514,544,484,485,485,486,486,456,458,459,459,460,460,430,430,431,431,432,339,340,340,310,310,280,280,281,280,279,279,309,279,278,277,247,245,215,215,185,185,184,184,154,154,124,154,155,155,156,154,153,251,252,252,253,253,223,223,193,189,159,480,510,510,540,540,541,541,571,571,572,572,542,571,570,579,580,580,581,581,551,551,552,552,522,522,523,523,553,553,554,554,584,584,583,583,582,584,585,585,555,555,556,556,526,526,496,496,497,497,467,467,468,468,498,498,499,499,500,500,501,501,531,531,530,530,529,529,559,559,589,589,590,590,560,560,561,561,591,591,592,592,593,593,563,563,533,533,534,534,535,535,565,565,595,595,594,594,564,595,596,596,566,566,536,536,537,537,507,507,506,506,476,476,446,446,416,416,386,386,385,385,415,415,414,414,444,444,445,445,475,475,474,474,504,504,503,503,502,502,472,472,473,473,443,443,442,442,441,441,411,411,410,410,409,409,439,439,438,438,408,408,378,378,377,377,347,347,346,346,376,376,406,406,407,407,437,437,436,436,435,435,465,465,495,495,494,494,493,493,492,494,524,524,525,494,464,465,466,435,405,405,375,375,374,374,373,373,343,346,316,316,286,286,256,256,257,257,287,287,288,288,318,318,317,318,319,319,349,349,350,350,380,380,379,380,381,381,351,351,352,352,353,353,323,323,324,324,325,325,326,326,356,356,357,357,387,387,417,417,418,418,419,419,389,389,359,359,329,329,299,299,298,298,328,328,358,358,388,328,327,327,297,297,296,296,295,295,265,265,264,264,294,294,293,293,263,263,233,233,232,232,231,231,201,201,171,201,200,200,230,230,229,229,259,259,258,258,228,228,227,259,289,289,290,290,260,260,261,261,262,262,292,292,322,322,321,321,291,321,320,265,266,266,236,236,206,206,176,176,177,177,178,178,208,208,209,209,179,179,149,149,148,148,147,147,117,117,116,116,86,86,87,87,57,57,56,56,26,26,27,27,28,28,58,58,88,88,118,118,119,119,89,89,59,59,29,116,146,209,239,239,269,269,268,268,267,267,237,237,207,237,238,419,449,449,479,479,478,478,477,477,447,447,448,478,508,508,509,509,539,539,538,538,568,568,569,569,599,599,598,598,597,597,567,356,355,355,354,354,384,384,383,383,382,382,412,412,413,349,348,256,255,439,469,469,470,470,471,470,440,502,532,532,562,504,505,589,588,588,558,558,528,528,527,527,557,557,587,587,586,522,521,521,520,520,550,198,168,168,138,138,139,53,83
